0
0
0000000000000000000001000000000
0000000000000000000001000000010
0000000000000000000001000000010
0000000000000000000001000000010
0000000000000000000001000000010
0000000000000000000001000000010
0000000000000000000001000000010
0000000000000000000001000000010
0000000000000000000001000000010
0000000000000000000001000000010
0000000000000000000001000000010
0000000000000000000001000000010
0000000000000000000001000000010
0000000000000000000001000000010
0000000000000000000001000000010
0000000000000000000001000000010
0000000000000000000001000000010
0000000000000000000001000000010
0000000000000000000001000000010
0000000000000000000001000000010
0000000000000000000001000000010
0000000000000000000001000000010
0000000000000000000001000000010
0000000000000000000001000000010
0000000000000000000001000000010
0000000000000000000001000000010
0000000000000000000001000000010
0000000000000000000001000000010
0000000000000000000001000000010
0000000000000000000001000000010
0000000000000000000001000000010
0000000000000000000001000000010
0000000000000000000001000000010
0000000000000000000001000000010
0000000000000000000001000000010
0000000000000000000001000000010
0000000000000000000001000000010
0000000000000000000001000000010
0000000000000000000001000000010
0000000000000000000001000000010
0000000000000000000001000000010
0000000000000000000001000000010
0000000000000000000001000000010
0000000000000000000001000000010
0000000000000000000001000000010
0000000000000000000001000000010
0000000000000000000001000000010
0000000000000000000001000000010
0000000000000000000001000000010
0000000000000000000001000000010
0000000000000000000001000000010
0000000000000000000001000000010
0000000000000000000001000000010
0000000000000000000001000000010
0000000000000000000001000000010
0000000000000000000001000000010
0000000000000000000001000000010
0000000000000000000001000000010
0000000000000000000001000000010
0000000000000000000001000000010
0000000000000000000001000000010
0000000000000000000001000000010
0000000000000000000001000000010
0000000000000000000001000000010
0000000000000000000001000000010
0000000000000000000001000000010
0000000000000000000001000000010
0000000000000000000001000000010
0000000000000000000001000000010
0000000000000000000001000000010
0000000000000000000001000000010
0000000000000000000001000000010
0000000000000000000001000000010
0000000000000000000001000000010
0000000000000000000001000000010
0111111111111111111111000000010
0000000000000000000000000000010
1111111111111111111111111111110
0000000000000000000000000000020