0
0
0000000000100000
1100000000000011
0000000000000000
0000001110100000
0010000000000000
1100000000010001
0010000010000001
1110100010000000
0010000000011100
0001001010110100
1011000001110100
0100000002110101
0000000001010000
1011001000000000
0011001000111111
0000100001000001
