7
9
1011010100000000
0000000011010100
1001000000000000
1010110101011000
0000010101001000
0010110000001001
0000000000000000
1000111100100011
1000100001000001
0002101001000000
0010110100000000
1000000010100000
0000001000001000
0000000001000000
1001001000000000
1000101101001011
