9
12
0100010100100100
0100010100010000
0000101110100110
0000000001100110
0000000100000001
0000000000000000
0001000001000110
0001000000000000
0001001101000000
0000000002101001
1001000001110010
0000010011111010
0000000010000010
0000000011110010
0100000000000010
0100011000010011
